R 1500 800

NO maps/textures/space1.xpm
SO maps/textures/space2.xpm
EA maps/textures/space3.xpm
WE maps/textures/space4.xpm

S maps/textures/tree.xpm

C 100, 230, 210
F 156, 209, 89

      10011111111111111111111
      11111110000000000011111    11111111   1
      110002000000000000011      1      1      1
11111111000000000111111001       1      1     1
111111110000011111111111111111111111111111111111111111111111111111111111111111111111111111111111111111111111111111111111111111111111111111111111111111111111111111111111111111111111111111111111111111111111111111111111111111111111111111111111111111111111111111111111111111111111111111111111111111111111111111111111111
100000000020010000000000000000000000000111110000000000001
100000000020010000000000000000000000000000110000000000001           
100000020000010000001001111110000111111111110000000000001              
111111100000000000111111    111111     100000000000000001
100020000N0000000011                   100000000000000001
1000000000111111001                   1000000000000000011          
111000000000000000111111111111111111111100000000000011111111                  
111111000000000000111111111111111111111100000000000000000011              
111111000000000000000000000000000000000000000000000000000011
     1111111100000000000000000000000000000000000000000000001
       11111111111111111111111111111111111111111111111111111
111111111111111111111111111111110000000000000000000000000000
100000000020010000000001   10001
100000020000010000001001   100001
11111110000000000011111    111111
1000200000000000011              
1000000000111111001                
1111110000000000011
1111000000000000001
   111111111111111
